10 12
2 3
9 11
2 3 2 1 4 4 3 2 1 4 1 2
0 1 2 4 4 5 4 3 2 1 0 1
2 0 3 3 1 2 1 3 4 1 2 3
5 4 4 3 0 1 2 1 2 3 1 4
4 3 2 1 1 4 3 2 3 5 2 1
2 1 0 5 4 3 2 1 2 3 3 2
3 4 5 3 4 1 0 2 3 4 4 3
1 2 3 4 3 2 1 1 0 4 5 2
4 3 2 1 2 3 4 3 4 0 3 4
3 2 1 4 4 3 2 1 4 3 2 1