20 20
2 3
18 17
2 3 2 1 4 4 3 2 1 4 1 2 3 4 1 2 3 4 5 5
0 1 2 3 4 5 4 3 2 1 0 1 2 3 4 5 3 2 1 0
2 0 3 3 1 2 1 3 4 1 2 3 4 1 2 3 4 5 5 4
1 4 4 3 0 1 2 1 2 3 1 4 1 2 3 4 4 3 2 1
4 3 2 1 1 4 3 2 3 4 2 1 4 3 2 1 3 4 5 4
2 1 0 2 4 3 2 1 2 3 3 2 1 4 3 2 2 3 4 3
3 4 2 3 4 1 0 2 3 4 4 3 2 1 2 3 4 1 2 1
1 2 3 4 3 2 1 1 0 4 1 2 3 4 1 2 3 4 5 4
4 3 2 1 2 3 4 3 4 0 3 4 1 2 3 2 1 2 3 4
3 2 1 4 4 3 2 1 4 3 2 1 4 3 2 1 3 4 5 5
2 3 4 1 2 3 4 1 2 3 4 1 2 3 4 1 2 3 4 5
4 1 2 3 4 1 2 3 4 1 2 3 4 1 2 3 4 1 2 3
3 4 1 2 3 4 1 2 3 4 1 2 3 4 1 2 3 4 1 2
2 3 4 1 2 3 4 1 2 3 4 1 2 3 4 1 2 3 4 5
1 2 3 4 1 2 3 4 1 2 3 4 1 2 3 4 1 2 3 4
1 2 3 4 1 2 3 4 1 2 3 4 1 2 3 4 1 2 3 4
1 2 3 4 1 2 3 4 1 2 3 4 1 2 3 4 1 2 3 4
1 2 3 4 1 2 3 4 1 2 3 4 1 2 3 4 1 2 3 4
1 2 3 4 1 2 3 4 1 2 3 4 1 2 3 4 1 2 3 4
1 2 3 4 1 2 3 4 1 2 3 4 1 2 3 4 1 2 3 4