8 9
1 2
3 4
2 3 2 1 4 4 0 0 0
0 0 0 0 0 0 0 0 0
2 0 3 3 1 2 1 0 1
1 4 4 3 0 1 2 0 3
4 3 2 1 1 4 3 0 4
2 1 0 2 4 3 2 0 2
3 4 2 3 4 1 0 0 1
1 2 3 4 3 2 1 0 4